World_v1
12 8
  0  -1  -1    0  -1  -1    0  -1  -1    0  -1  -1    0  -1  -1    0  -1  -1    0  -1  -1    0  -1  -1    0  -1  -1    0  -1  -1    0  -1  -1    0  -1  -1  
  0  -1  -1    0  -1  -1    0  -1  -1    0  -1  -1    0  -1  -1    0  -1  -1    0  -1  -1    0  -1  -1    0  -1  -1    0  -1  -1    0  -1  -1    0  -1  -1  
  2  -1  -1    2  -1  -1    2  -1  -1    2  -1  -1    2  -1  -1    2  -1  -1    7  -1  -1    0  -1  -1    0  -1  -1    0  -1  -1    0  -1  -1    0  -1  -1  
  1  -1  -1    1  -1  -1    1  -1  -1    1  -1  -1    1  -1  -1    1  -1  -1    6  -1  -1    0  -1  -1    0   9  -1    0  -1  -1    0  -1  -1    0  -1  -1  
  3  -1  -1    3  -1  -1    3  -1  -1    3  -1  -1    3  -1  -1    3  -1  -1    5  -1  -1    0  -1  -1    0  -1  -1    0   9  -1    0  -1  -1    0  -1  -1  
  0  -1  -1    0  -1  -1    0   4  -1    0   4  -1    0   4  -1    0   4  -1    0   4  -1    0   4  -1    0   4  -1    0   4  -1    0  -1  -1    0  -1  -1  
  0  -1  -1    0  -1  -1    0  -1  -1    0  -1  -1    0  -1  -1    0  -1  -1    0  -1  -1    0  -1  -1    0  -1  -1    0  -1  -1    0  -1  -1    0  -1  -1  
  0  -1  -1    0  -1  -1    0  -1  -1    0  -1  -1    0  -1  -1    0  -1  -1    0  -1  -1    0  -1  -1    0  -1  -1    0  -1  -1    0  -1  -1    0  -1  -1  
9

64 32
0
10

64 64
1
11

64 96
3
12

64 32
0
13

64 64
1
10

64 96
3
11

64 32
0
10

64 64
1
12

64 96
3
13

